###########################################
#.........................................#
#.........................................#
#.........................................#
#.........................................#
#.......................#############.....#
#.........................................#
#.........................................#
###########################################